# # # # # # # # # # # # # # #
# 1 . . . . . . % . . . . . #
# . F X . . . . % . T F . . #
# . . . . S . . . . S . . . #
# % % % . . . ? . O ? . . . #
# . . . O . X . . . X . . . #
# . X ? S . % . . . . . . . #
# . H . X . % . T ? O . X . #
# . H . O . S . . O . . . . #
# . F . . . F O . L . % % % #
# . . % . O . . . . . . . . #
# . . . . . % . H O . . O . #
# . T F H . % . . . X . T . #
# . . . . . % . . . . . . 2 #
# # # # # # # # # # # # # # #