# # # # # # # # # # # # # # #
# S . . . . X . X . . . F F #
# X . . . H X X X . . . F F #
# . . . . % . . . . . . . . #
# . . . . . H . . % . . . . #
# . . . . . . . . . . . . . #
# T . . . ! X X X . . . H 1 #
# 2 H . . X X X ! . . . . F #
# . . . . . . . . . . . . . #
# . S ! . . . . . . . . . . #
# . . . H # # # . . . . . % #
# . . . . . . . . . . . . . #
# T T . . X X X . . . . . X #
# T T . . X . X H . . . . S #
# # # # # # # # # # # # # # #
